1111111111111111111111111111111
1000000000C000000000000000000C1
1011011111111111101111111011101
101100000C0000011011100C0001101
1011011111111101101110111101101
101100000C1111011C111011100C101
1011111111111101111110111011101
1011111000000000000C10111011101
10000C10110000P000001C111011101
1011111C110000000000111C0011101
101C001011C00000000C1110000C001
1011101011011110111111101111111
10111000111111100000C0001111111
10111110000000011111111110E1111
1011111111011101111111111001111
1C00000000011100000C00000011111
1111111111111111111111111111111