11111111111
1C1000C0000
10000100010
1001P000000
10011110000
10C1E000C10
11111111111