11111111111
1C1000C0001
10000100011
1001P0000011
10011110001
10C1E000C11
11111111111