1111111111111111111
1000100001000100101
1000100000000010001
1000100001000000101
1000000011000001001
100C11110E111111P01
1000000100100000001
1000101101010000001
1000100100110000001
1000010010000100001
1000001000000010001
1000000110000001001
1000000001000001001
1000000000100001001
1000000000011110001
1000000000000000001
1111111111111111111