11111111111
1C1000C0001
10000100011
1001P000001
10011110001
10C1E000C11
11111111111